3,3,12,12,4,4,3,3,3,4,11,11,4,4,4,4,3,3,3,12,12,3,3,3,12,12,11,11,3,3,3,3
3,3,3,4,11,11,4,3,4,11,11,4,4,11,11,11,4,12,12,3,3,3,3,3,3,3,3,11,11,12,12,3
4,4,4,3,4,11,11,4,12,12,3,3,3,4,11,11,11,4,3,3,12,12,3,10,9,9,9,9,9,9,9,9
4,11,11,4,3,4,4,4,3,3,5,3,12,12,12,12,12,12,12,12,13,13,9,9,9,10,3,3,3,3,3,3
1,4,11,11,4,3,12,12,12,12,12,12,13,13,13,13,13,13,13,13,9,9,9,12,3,3,3,3,3,3,3,3
1,1,4,4,4,12,13,13,13,13,13,13,9,9,9,9,9,9,9,9,9,12,12,12,12,3,2,2,2,2,2,3
12,1,1,12,12,13,9,9,9,9,9,9,9,10,10,10,10,11,11,10,9,3,3,12,20,18,18,18,8,18,18,18
9,9,9,9,9,9,9,10,10,10,10,10,10,11,3,3,3,3,11,11,9,3,3,3,21,3,3,3,3,3,3,3
10,1,12,3,3,12,10,10,10,10,10,10,11,11,3,12,12,3,3,3,9,3,2,2,21,3,3,3,3,3,3,3
1,1,12,3,12,3,3,10,10,10,10,10,11,3,3,3,12,12,3,3,9,3,2,2,21,3,3,3,3,3,3,3
1,12,3,3,12,3,10,10,10,10,10,10,3,3,3,3,3,3,3,3,9,3,2,2,7,3,3,3,6,3,3,3
1,12,3,12,3,3,3,10,10,10,10,10,10,3,3,3,12,12,3,3,9,3,2,2,21,3,3,3,3,3,3,3
12,1,3,12,3,3,10,10,10,10,10,10,3,3,12,12,3,3,3,12,9,12,2,2,21,3,3,3,3,3,3,3
12,1,3,12,3,3,11,10,10,10,10,10,10,3,3,3,3,12,12,13,9,12,12,12,21,3,3,3,3,3,3,3
1,1,12,3,3,11,11,10,10,10,10,10,10,12,3,3,12,13,13,13,9,9,12,12,17,18,18,18,22,18,18,18
1,3,3,12,12,11,12,13,13,13,13,13,13,13,12,3,3,12,13,13,13,9,13,12,12,3,3,3,3,3,3,3
12,3,3,3,3,12,12,12,13,13,13,13,12,12,3,3,3,3,12,13,13,9,12,11,11,3,3,3,3,3,3,12
3,12,12,3,12,3,3,12,12,13,13,12,12,3,3,3,3,3,3,12,12,9,11,11,3,3,3,3,3,11,11,12
12,3,3,12,3,12,3,3,3,12,12,3,3,3,12,12,3,3,3,3,3,9,3,3,3,3,3,12,11,11,12,12
