3,12,4,3,4,3,12,11,11,12,1,4,3,4,12,4,4,4,4,4,10,10,10,4,4,4,12,3,3,11,11,3
4,12,10,3,3,12,11,11,12,1,4,12,12,3,3,12,10,10,10,4,4,4,4,10,11,11,4,4,3,3,11,11
4,3,12,10,12,11,11,12,1,1,12,10,10,12,3,4,12,12,10,10,10,10,4,4,4,4,11,11,4,3,3,4
12,3,12,4,4,12,12,1,1,12,10,10,12,3,4,10,12,12,10,13,12,4,10,10,10,4,4,4,4,12,12,10
12,3,12,4,10,3,1,4,12,10,10,12,3,4,12,11,11,12,12,12,13,10,4,4,4,10,10,10,4,4,4,4
3,12,4,12,1,10,4,12,10,10,12,3,4,10,10,9,9,9,9,12,12,13,10,10,4,4,4,4,10,10,10,4
4,12,1,12,1,4,12,10,10,12,3,4,10,10,9,9,9,9,9,9,12,13,13,12,10,10,12,12,4,4,4,3
10,1,1,12,10,4,3,12,12,3,4,10,10,9,9,4,10,10,9,9,12,12,13,13,12,4,10,4,3,3,3,3
11,11,1,1,12,10,3,3,3,4,10,10,9,9,4,10,11,11,10,9,9,12,13,13,12,4,4,3,3,12,12,3
12,1,11,11,12,3,3,3,3,4,10,9,9,4,11,11,10,4,10,9,9,12,12,13,13,12,3,3,11,11,3,3
12,3,3,3,12,9,9,9,9,9,9,9,4,11,11,4,10,4,10,10,9,12,12,13,13,12,3,3,3,3,11,11
9,9,9,9,9,9,11,11,3,3,3,4,11,11,4,10,4,3,3,10,9,3,12,12,13,12,2,2,2,2,2,3
12,3,3,3,10,10,12,12,12,3,3,4,4,4,3,3,3,12,3,3,9,3,3,12,13,12,2,2,2,2,2,3
12,3,3,3,3,4,13,13,13,12,12,12,3,3,3,12,12,13,12,3,9,3,3,12,20,18,18,18,8,18,18,18
3,3,10,10,10,4,4,4,4,13,13,13,12,12,12,13,13,12,12,3,9,3,3,2,21,3,3,3,3,3,3,3
3,11,11,11,11,10,10,10,4,4,4,4,13,13,13,12,12,3,3,3,9,3,3,2,21,3,3,3,3,3,3,3
3,3,12,12,12,11,11,11,10,10,10,4,4,12,12,3,3,3,3,3,9,3,3,2,7,3,3,3,6,3,3,3
12,3,3,3,3,12,12,12,11,11,11,11,4,3,3,3,3,12,12,3,9,3,3,2,21,3,3,3,3,3,3,3
13,13,12,12,3,3,3,3,3,3,3,3,3,3,3,12,12,13,13,12,9,12,3,2,21,3,3,3,3,3,3,3
