12,12,9,9,12,3,3,3,3,3,12,12,12,12,12,12,3,3,3,3,3,3,11,11,12,3,1,1,11,3,3,11
9,9,9,12,3,3,4,3,3,3,3,12,12,12,12,3,3,3,4,12,11,3,3,12,13,12,3,1,1,3,3,3
12,12,12,3,3,12,12,4,3,3,3,3,12,12,3,3,3,4,12,13,12,4,3,12,13,13,12,3,1,3,11,3
3,3,3,3,4,12,13,12,4,3,3,4,4,4,4,4,4,12,13,13,13,12,4,3,12,13,12,3,3,11,11,3
11,4,4,11,4,4,12,13,12,4,4,10,10,10,10,12,12,13,9,9,9,9,12,12,3,12,3,3,3,11,3,3
4,11,4,11,11,4,12,13,13,12,10,10,10,10,12,13,13,9,9,9,9,9,9,12,3,3,1,1,1,3,3,3
4,11,4,4,11,4,4,12,13,10,10,10,10,13,13,9,9,9,9,9,9,9,9,9,3,3,11,1,1,3,12,3
3,4,11,4,4,3,4,10,10,10,10,10,13,9,9,9,9,9,9,9,9,9,9,9,9,3,3,3,3,3,12,12
3,3,4,3,3,3,3,4,10,10,10,9,9,9,9,9,9,9,9,9,9,9,9,9,9,9,12,12,12,3,3,12
3,3,3,3,3,3,3,3,4,10,10,9,9,9,9,9,9,9,9,9,9,9,9,9,9,9,9,9,9,12,3,3
3,14,2,2,2,14,3,3,3,4,10,9,9,9,9,9,9,9,9,9,9,9,9,9,9,9,9,9,9,9,9,3
2,2,2,2,2,2,2,3,4,11,10,10,9,9,9,9,9,9,9,9,9,9,13,13,13,13,13,13,9,9,9,9
3,2,2,2,2,2,3,4,11,11,4,10,9,9,9,9,9,9,9,9,13,13,12,12,12,10,10,10,13,12,9,9
18,18,18,8,18,18,18,20,11,4,3,3,3,9,9,9,9,9,13,13,12,12,4,12,4,12,10,10,12,1,1,1
3,3,3,3,3,3,3,21,4,3,3,3,3,3,9,9,9,13,12,12,4,4,12,4,12,13,12,4,3,11,1,1
3,3,3,3,3,3,3,21,3,3,3,3,3,3,12,13,13,12,4,4,4,11,4,12,12,13,12,11,3,3,12,3
3,3,3,6,3,3,3,7,3,3,3,3,3,3,12,13,13,12,3,3,3,4,4,12,13,12,11,3,3,12,13,12
3,3,3,3,3,3,3,21,3,3,3,11,11,3,3,12,12,3,12,12,12,3,4,12,13,12,3,3,12,13,12,3
3,3,3,3,3,3,3,21,3,3,3,3,11,11,3,3,3,12,13,13,13,12,3,12,12,3,3,3,3,12,3,11
