3,3,1,1,1,3,4,12,10,10,12,12,4,3,3,3,3,12,12,12,3,3,3,3,3,10,11,11,4,12,9,9
4,1,1,12,12,10,4,4,12,12,13,13,12,4,3,5,3,3,3,3,3,10,10,12,3,3,3,11,11,4,12,9
12,1,12,12,13,12,12,4,3,4,12,13,13,12,4,3,3,11,12,12,3,3,12,13,12,3,3,3,3,10,10,12
13,12,1,12,12,13,13,12,4,3,4,12,13,12,4,3,3,12,13,13,12,3,12,13,13,12,3,3,3,3,3,4
12,1,1,12,12,13,13,12,12,4,3,4,12,4,3,4,12,13,13,13,12,3,3,12,13,13,12,3,3,3,3,3
12,1,1,4,12,12,13,13,12,12,4,3,4,3,4,12,13,13,13,12,4,3,3,14,12,3,20,18,18,22,18,18
4,1,1,4,12,12,12,13,12,12,12,4,4,11,11,13,13,13,12,4,3,3,11,3,2,2,21,3,3,3,3,3
3,1,1,3,4,12,12,13,13,13,12,12,11,11,11,13,12,12,4,3,3,11,3,3,2,2,21,3,3,3,3,3
10,3,3,11,3,12,12,12,13,13,13,13,13,11,11,11,11,4,3,3,11,3,3,3,2,2,7,3,3,6,3,3
3,10,3,11,11,3,12,12,12,13,13,13,13,12,11,11,4,3,3,3,3,3,3,3,2,2,21,3,3,3,3,3
3,3,3,3,11,3,12,12,12,12,13,13,13,12,4,4,3,12,4,11,11,11,3,3,2,2,21,3,3,3,3,3
4,3,3,3,3,3,3,12,12,12,13,13,13,12,4,3,12,13,12,4,11,11,11,14,3,3,17,18,18,8,18,18
12,4,4,3,3,3,12,3,12,12,13,13,13,13,12,3,12,13,13,12,12,12,4,3,3,3,3,2,2,2,2,2
9,12,4,4,4,12,13,12,3,12,12,13,13,13,13,12,3,12,13,13,13,13,12,4,3,3,3,3,3,3,3,3
9,9,12,4,10,4,12,13,12,3,12,12,13,13,13,13,12,3,12,12,13,13,13,12,4,4,11,11,3,3,3,3
12,9,9,12,4,10,4,12,13,12,3,3,12,12,12,12,3,3,4,4,12,12,12,13,12,12,4,4,4,3,3,11
4,12,9,9,12,4,10,4,12,4,10,3,3,3,3,3,3,11,11,4,4,10,10,12,13,13,12,10,10,3,11,11
3,4,12,9,9,12,4,10,4,10,3,3,4,12,12,12,12,10,4,11,11,4,4,10,12,12,10,10,4,3,3,11
3,3,4,12,9,9,12,4,3,3,3,4,12,13,13,13,13,12,10,4,4,11,11,4,4,4,4,4,3,3,3,3
